LABIRINTO 10 10
1 1 1 1 1 1 1 1 1 0 
1 1 1 1 1 1 1 1 0 1 
1 1 1 1 1 1 1 1 1 1 
1 1 1 1 1 1 1 1 1 1 
1 1 1 1 1 0 1 1 1 1 
1 1 1 1 0 1 1 1 1 1 
1 1 1 1 1 1 1 1 1 1 
1 1 1 1 1 1 1 1 1 1 
1 0 1 1 1 1 1 1 1 1 
0 1 1 1 1 1 1 1 1 1
QUESTÃO 01
Origem: 0 0
Destino: 9 9
Tempo=0.309ms
Num nos ABERTO=33
Num nos FECHADO=42
Comprimento=15.6651
Profundidade=12

LABIRINTO 10 10
1 1 1 0 1 1 1 1 1 1 
1 1 1 0 1 1 1 1 1 1 
1 1 1 0 1 1 1 1 1 1 
1 1 1 0 1 1 1 1 1 1 
0 1 1 0 1 1 1 1 1 1 
1 0 1 0 1 1 1 1 1 1 
1 0 1 0 1 1 1 1 1 1 
1 0 1 0 1 1 1 1 1 1 
1 1 0 1 1 1 1 1 1 1 
1 1 1 1 1 1 1 1 1 1
QUESTÃO 02
Origem: 0 0
Destino: 9 9
Tempo=0.0946ms
Num nos ABERTO=0
Num nos FECHADO=17
Comprimento=-1.0000
Profundidade=-1

LABIRINTO 10 10
1 1 1 0 1 1 1 1 1 1 
1 1 1 0 1 1 1 1 1 1 
1 1 1 0 1 1 1 1 1 1 
1 1 1 0 1 1 1 1 1 1 
0 1 1 0 1 1 1 1 1 1 
1 0 1 0 1 1 1 1 1 1 
1 0 1 0 1 1 1 1 1 1 
1 0 1 0 1 1 1 1 1 1 
1 1 0 1 1 1 1 1 1 1 
1 1 1 1 1 1 1 1 1 1
QUESTÃO 03
Origem: 9 9
Destino: 0 0
Tempo=0.4072ms
Num nos ABERTO=0
Num nos FECHADO=70
Comprimento=-1.0000
Profundidade=-1

LABIRINTO 10 25
1 1 1 1 0 1 1 1 1 1 1 1 1 1 1 1 1 1 1 1 1 1 1 1 1
1 1 1 1 0 1 1 1 1 1 1 1 1 1 1 1 1 1 1 1 1 1 1 1 1
1 1 1 1 0 1 1 1 1 1 1 1 0 0 0 0 0 0 0 0 1 1 1 1 1
1 1 1 1 0 1 1 1 1 1 1 1 0 0 0 0 0 0 0 0 1 1 1 1 1
1 1 1 1 0 1 1 1 0 1 1 1 1 1 1 1 1 1 0 0 1 1 1 1 1
1 1 1 1 0 1 1 1 0 1 1 1 1 1 1 1 1 1 0 0 1 1 1 1 1
1 1 1 1 1 1 1 1 0 1 1 1 0 0 0 0 0 0 0 0 1 1 1 1 1
1 1 1 1 1 1 1 1 0 1 1 1 0 0 0 0 0 0 0 0 1 1 1 1 1
1 1 1 1 1 1 1 1 0 1 1 1 1 1 1 1 1 1 1 1 1 1 1 1 1
1 1 1 1 1 1 1 1 0 1 1 1 1 1 1 1 1 1 1 1 1 1 1 1 1
QUESTÃO 04
Origem: 0 0
Destino: 5 24
Tempo=0.7862ms
Num nos ABERTO=36
Num nos FECHADO=109
Comprimento=35.7020
Profundidade=28

LABIRINTO 12 36
1 1 1 1 1 1 1 1 1 1 1 1 0 1 0 1 1 1 1 1 1 1 1 0 0 0 1 1 1 1 1 1 1 1 1 1
1 1 1 1 1 1 1 1 1 1 1 0 1 1 1 0 1 1 1 1 1 1 1 0 0 0 1 1 1 1 1 1 1 1 1 1
1 1 1 1 1 1 1 1 1 1 0 1 1 1 1 1 0 1 1 1 1 1 1 0 0 0 1 1 1 1 1 1 1 1 1 1
1 1 1 1 1 1 1 1 1 0 1 1 1 1 1 1 1 0 1 1 1 1 1 0 0 0 1 1 1 1 1 1 0 1 1 1
1 1 1 1 1 1 1 1 0 1 1 1 1 1 1 1 1 1 0 1 1 1 1 0 0 0 1 1 1 1 1 0 1 1 1 1
1 1 1 1 1 1 1 0 1 1 1 1 1 1 1 1 1 1 1 0 1 1 1 0 0 0 1 1 1 1 0 1 1 1 1 1
1 1 1 1 1 1 0 1 1 1 1 1 1 1 1 1 1 1 1 1 0 1 1 1 1 1 1 1 1 0 1 1 1 1 1 1
1 1 1 1 1 0 1 1 1 1 1 1 0 0 0 1 1 1 1 1 1 0 1 1 1 1 1 1 0 1 1 1 1 1 1 1
1 1 1 1 0 1 1 1 1 1 1 1 0 0 0 1 1 1 1 1 1 1 0 1 1 1 1 0 1 1 1 1 1 1 1 1
1 1 1 0 1 1 1 1 1 1 1 1 0 0 0 1 1 1 1 1 1 1 1 1 1 1 0 1 1 1 1 1 1 1 1 1
1 1 1 1 1 1 1 1 1 1 1 1 0 0 0 1 1 1 1 1 1 1 1 1 1 0 1 1 1 1 1 1 1 1 1 1
1 1 1 1 1 1 1 1 1 1 1 1 0 0 0 1 1 1 1 1 1 1 1 1 0 1 1 1 1 1 1 1 1 1 1 1
QUESTÃO 05
Origem: 0 0
Destino: 11 35
Tempo=2.2885ms
Num nos ABERTO=28
Num nos FECHADO=271
Comprimento=61.7811
Profundidade=50

LABIRINTO 10 25
0 1 0 1 0 1 1 0 1 1 0 0 0 1 1 0 1 1 1 1 1 1 1 1 1 
0 0 0 1 1 1 0 0 0 1 0 1 0 0 1 1 0 1 0 1 1 1 1 0 1 
1 0 1 1 0 1 1 1 0 0 1 0 0 0 1 0 1 1 1 1 1 1 1 0 0 
1 1 0 0 1 0 1 1 1 1 0 0 0 0 1 0 0 1 1 0 1 0 0 1 0 
1 0 0 0 1 1 1 1 1 1 1 0 1 0 1 1 1 1 0 1 1 1 1 1 0 
1 1 1 1 1 0 1 1 1 1 0 1 0 1 1 0 1 1 0 1 0 1 1 1 0 
1 1 1 1 1 1 1 1 1 1 1 0 1 1 1 1 0 0 0 0 0 1 1 0 1 
0 1 0 0 1 1 0 0 1 1 1 1 1 1 0 0 1 0 0 0 1 1 1 1 1 
0 1 0 1 0 1 0 1 1 1 1 1 0 1 1 1 0 1 1 1 1 1 1 1 0 
0 0 0 1 1 0 0 1 0 0 1 0 0 1 0 1 0 0 1 0 0 0 1 0 0 
QUESTÃO 06
Origem: 2 0
Destino: 0 24
Tempo=0.4597ms
Num nos ABERTO=10
Num nos FECHADO=92
Comprimento=37.4047
Profundidade=29

LABIRINTO 10 25
0 1 0 1 1 1 1 0 1 1 0 0 0 1 1 0 1 1 1 1 1 1 1 1 1 
0 0 0 1 1 1 0 0 0 1 0 1 0 0 1 1 0 1 0 1 1 1 1 0 1 
1 0 1 1 0 1 1 1 0 0 1 0 0 0 1 0 1 1 1 1 1 1 1 0 0 
1 1 0 0 1 0 1 1 1 1 0 0 0 0 1 0 0 1 1 0 1 0 0 1 0 
1 0 0 0 1 1 1 1 1 1 1 0 1 0 1 1 1 1 0 1 1 1 1 1 0 
1 1 1 1 1 0 1 1 1 1 0 1 0 1 1 0 1 1 0 1 0 1 1 1 0 
1 1 1 1 1 1 1 1 1 1 1 0 1 1 1 1 0 0 0 0 0 1 1 0 1 
0 1 0 0 1 1 0 0 1 1 1 1 1 1 0 0 1 0 0 0 1 1 1 1 1 
0 1 0 1 0 1 0 1 1 1 1 1 0 1 1 1 0 1 1 1 1 1 1 1 0 
0 0 0 1 1 0 0 1 0 0 1 0 0 1 0 # 0 0 1 0 0 0 1 0 0 
QUESTÃO 07
Origem: 0 4
Destino: 7 24
Tempo=0.4291ms
Num nos ABERTO=12
Num nos FECHADO=84
Comprimento=33.5815
Profundidade=24

LABIRINTO 10 10
1 1 1 1 1 1 1 1 1 1 
1 1 0 0 0 0 0 0 0 1 
1 1 1 1 0 0 0 0 0 1 
1 0 1 1 1 0 0 0 0 1 
1 0 0 1 1 0 0 0 0 1 
1 0 0 0 1 1 1 0 0 1 
1 0 0 0 0 1 1 1 0 1 
1 0 0 0 0 0 0 1 1 1 
1 0 0 0 0 0 0 0 1 1 
1 1 1 1 1 1 1 1 1 1
QUESTÃO 08
Origem: 0 0
Destino: 9 9
Tempo=0.1599ms
Num nos ABERTO=3
Num nos FECHADO=51
Comprimento=18.7950
Profundidade=18

LABIRINTO 10 10
1 1 1 1 1 1 1 1 1 1 
1 0 0 0 0 0 0 0 0 1 
1 0 1 1 1 1 1 1 0 1 
1 0 1 1 1 1 1 1 0 1 
1 0 1 1 1 1 1 1 0 1 
1 0 1 1 1 1 1 1 0 1 
1 0 1 1 1 1 1 1 0 1 
1 0 1 1 1 1 1 1 0 1 
1 0 1 1 1 1 1 1 0 1 
1 1 1 1 1 1 1 1 1 1
QUESTÃO 09
Origem: 0 0
Destino: 2 7
Tempo=0.1244ms
Num nos ABERTO=21
Num nos FECHADO=34
Comprimento=21.6490
Profundidade=18

LABIRINTO 10 10
1 1 1 1 1 1 1 1 1 1 
1 0 0 0 0 0 0 0 0 1 
1 0 1 1 1 1 1 1 0 1 
1 0 1 1 1 1 1 1 0 1 
1 0 1 1 1 1 1 1 0 1 
1 0 1 1 1 1 1 1 0 1 
1 0 1 1 1 1 1 1 0 1 
1 0 1 1 1 1 1 1 0 1 
1 0 1 1 1 1 1 1 0 1 
1 1 1 1 1 1 1 1 1 1
QUESTÃO 10
Origem: 9 0
Destino: 0 9
Tempo=0.4234ms
Num nos ABERTO=1
Num nos FECHADO=75
Comprimento=18.7940
Profundidade=18

